(Di)nucleoside polyphosphate hydrolase	(Di)nucleoside polyphosphate hydrolase
2,3,4,5-tetrahydropyridine-2-carboxylate N-succinyltransferase DapD	2,3,4,5-tetrahydropyridine-2-carboxylate N-succinyltransferase DapD
3-dehydroquinate dehydratase, type II	type II 3-dehydroquinate dehydratase
3-deoxy-D-manno-octulosonate 8-phosphate phosphatase (KDO 8-P phosphatase)	3-deoxy-D-manno-octulosonate 8-phosphate phosphatase
3-deoxy-D-manno-octulosonate cytidylyltransferase	3-deoxy-D-manno-octulosonate cytidylyltransferase
3-oxoacyl-(acyl-carrier-protein) reductase	3-oxoacyl-[acyl-carrier-protein] reductase
3-polyprenyl-4hydroxybenzoate decarboxylase	3-polyprenyl-4-hydroxybenzoate decarboxylase
4Fe-4S ferredoxin, iron-sulfur binding	
4Fe-4S ferredoxin, iron-sulfur binding domain protein	
5,10-methenyltetrahydrofolate synthetase	5,10-methenyltetrahydrofolate synthetase
5-methyltetrahydropteroyltriglutamate-- homocystei ne methyltransferase	5-methyltetrahydropteroyltriglutamate--homocysteine methyltransferase
50S ribosomal protein L5 (BL6)	50S ribosomal protein L5
AAA ATPase superfamily	AAA ATPase superfamily
ABC transport permease protein-involved in lipoprotein release	ABC transport permease protein
ABC transport system permease	ABC transport system permease
ABC transporter phosphate binding protein	ABC transporter phosphate binding protein
ABC transporter, ATP-binding/permease protein	ABC transporter ATP-binding/permease protein
ABC-type Co2  transport system, periplasmic component	ABC-type Co2 transport system, periplasmic component
ABC-type dipeptide/oligopeptide/nickel transport system, permease component	ABC-type dipeptide/oligopeptide/nickel transport system, permease component
ABC-type multidrug transport system permease component	ABC-type multidrug transport system permease component
ATP synthase C chain (Lipid-binding protein)(Dicyclohexylcarbodiimide-binding protein)	ATP synthase C chain
ATP synthase F0, A subunit	ATP synthase F0, A subunit
ATP synthase F1, alpha subunit	ATP synthase F1, alpha subunit
ATP synthase F1, beta subunit	ATP synthase F1, beta subunit
ATP synthase F1, delta subunit	ATP synthase F1, delta subunit
ATP synthase F1, epsilon subunit	ATP synthase F1, epsilon subunit
ATP synthase F1, gamma subunit	ATP synthase F1, gamma subunit
ATP-dependent Clp protease adaptor protein ClpS	ATP-dependent Clp protease adaptor protein ClpS
ATP-dependent Clp protease, proteolytic subunit ClpP	ATP-dependent Clp protease, proteolytic subunit ClpP
ATP-dependent DNA helicase, UvrD/REP family	ATP-dependent DNA helicase, UvrD/REP family
ATP-dependent protease HslV	ATP-dependent protease HslV
ATP-dependent protease La	ATP-dependent protease La
ATPase subunit 6	ATPase subunit 6
ATPase, AAA family	ATPase, AAA family
ATPase, ParA family	ATPase, ParA family
AcrB protein	AcrB protein
ApxIVA Var3	ApxIVA protein
ArsC	ArsC protein
CDP-diacylglycerol--serine O-phosphatidyltransferse	CDP-diacylglycerol--serine O-phosphatidyltransferse
Cb-type cytochrome c oxidase subunit iii	Cb-type cytochrome c oxidase subunit III
CbiM	CbiM protein
CjaC	CjaC protein
CmeA	CmeA protein
ComEC/Rec2 family protein	
Cpp12	Cpp12 protein
Cpp14	Cpp14 protein
Cpp17	Cpp17 protein
Cpp33	Cpp33 protein
Cpp44	Cpp44 protein
Cpp45	Cpp45 protein
Cps2I	Cps2I protein
CrcB protein	
CvpA family protein	CvpA family protein
D-alanine--D-alanine ligase (D-alanylalanine synthetase)(D-Ala-D-Ala ligase)	D-alanine--D-alanine ligase
D12 class N6 adenine-specific DNA methyltransferase	D12 class N6 adenine-specific DNA methyltransferase
DNA gyrase, A subunit	DNA gyrase, A subunit
DNA gyrase, B subunit	DNA gyrase, B subunit
DNA ligase (Polydeoxyribonucleotide synthase [ATP])	DNA ligase
DNA ligase, NAD-dependent	DNA ligase, NAD-dependent
DNA methylase	
DNA polymerase I (POL I)	DNA polymerase I
DNA polymerase III, beta subunit	
DNA polymerase III, delta subunit superfamily	DNA polymerase III, delta subunit superfamily
DNA topoisomerase 3 (DNA topoisomerase III)	DNA topoisomerase III
DNA-binding protein HU 1 (DNA-binding protein II) (HB)	DNA-binding protein HU 1
DNA-binding response regulator	DNA-binding response regulator
DNA-directed RNA polymerase, alpha subunit	DNA-directed RNA polymerase, alpha subunit
DNA-directed RNA polymerase, omega subunit	DNA-directed RNA polymerase, omega subunit
DnaJ domain protein	DnaJ domain protein
DnaK suppressor protein	DnaK suppressor protein
DoxX	DoxX protein
ExbB\TolQ family transport protein	ExbB/TolQ family transport protein
ExsB protein	ExsB protein
G:T/U mismatch-specific DNA glycosylase	G:T/U mismatch-specific DNA glycosylase
GMP synthase [glutamine-hydrolyzing] (Glutamineamidotransferase) (GMP synthetase)	GMP synthase [glutamine-hydrolyzing]
GTP cyclohydrolase I	GTP cyclohydrolase I
GTP cyclohydrolase II	GTP cyclohydrolase II
GTP pyrophosphokinase (ATP:GTP 3'-pyrophosphotransferase)(ppGpp synthetase I) ((P)ppGpp synthetase)	GTP pyrophosphokinase
GTP-binding protein EngA	GTP-binding protein EngA
GTP-binding protein Era	GTP-binding protein Era
GTP-binding protein LepA	GTP-binding protein LepA
GTP-binding protein Obg/CgtA	GTP-binding protein Obg/CgtA
GTP-binding protein YchF	GTP-binding protein YchF
GatB/Yqey family protein	GatB/Yqey family protein
HAD-superfamily hydrolase, subfamily IA, variant 1 family protein	HAD-superfamily hydrolase, subfamily IA, variant 1 family protein
HAD-superfamily hydrolase, subfamily IIA	HAD-superfamily hydrolase, subfamily IIA
HIT family protein	
Ham1 family	Ham1 family protein
Hit family protein	
HrgA protein	HrgA protein
Ig family protein	Ig family protein
IspD/IspF bifunctional enzyme	
KpsF/GutQ	KpsF/GutQ protein
L-asparaginase II	L-asparaginase II
L-fuculose-1-phosphate aldolase	L-fuculose-1-phosphate aldolase
L-seryl-tRNA selenium transferase	L-seryl-tRNA selenium transferase
LemA family protein	LemA family protein
LysM domain protein	LysM domain-containing protein
MTA/SAH nucleosidase	MTA/SAH nucleosidase
MacA	MacA protein
MauM/NapG ferredoxin-type protein	MauM/NapG ferredoxin-type protein
MloA	MloA protein
Mrp protein	Mrp protein
Mug G:T/U mismatch-specific DNA glycosylase	Mug G:T/U mismatch-specific DNA glycosylase
Mur ligase family protein	Mur ligase family protein
N- methylation	hypothetical protein
N-(5'phosphoribosyl)anthranilate isomerase	N-(5'phosphoribosyl)anthranilate isomerase
NAD  synthetase	NAD synthetase
NAD-dependent deacetylase (Regulatory protein SIR2-like protein)	NAD-dependent deacetylase
NADH dehydrogenase (quinone), d subunit	NADH dehydrogenase (quinone), d subunit
NADH dehydrogenase gamma subunit	NADH dehydrogenase gamma subunit
NADH dehydrogenase ndh	
NADH dehydrogenase subunit 4	NADH dehydrogenase subunit 4
NADH-quinone oxidoreductase chain l (nadh dehydrogenasei, chain l) (ndh-1, chain l)	
NADH-quinone oxidoreductase chain m (nadh dehydrogenasei, chain m) (ndh-1, chain m)	NADH-quinone oxidoreductase subunit M
NADH-quinone oxidoreductase subunit h (nadhdehydrogenase i subunit h) (ndh-1 subunit h)	NADH-quinone oxidoreductase subunit h
NADH-quinone oxidoreductase subunit i (nadhdehydrogenase i subunit i) (ndh-1 subunit i)	NADH-quinone oxidoreductase subunit I
NADH-quinone oxidoreductase, b subunit	NADH-quinone oxidoreductase, b subunit
NADH-quinone oxidoreductase, j subunit	
NADH-quinone oxidoreductase, k subunit	NADH-quinone oxidoreductase, k subunit
NADH-ubiquinone oxidoreductase chain 3 (nadhdehydrogenase subunit 3)	
NADP-dependent l-serine/l-allo-threonine dehydrogenase ydfg	NADP-dependent l-serine/l-allo-threonine dehydrogenase ydfG
NADP-dependent malic enzyme (nadp-me)	NADP-dependent malic enzyme
NADPH-dependent 7-cyano-7-deazaguanine reductase (nadph-dependent nitrile oxidoreductase)	NADPH-dependent 7-cyano-7-deazaguanine reductase (nadph-dependent nitrile oxidoreductase)
NLP/P60	NLP/P60 protein
Na /H  antiporter family	sodiumâ€“hydrogen antiporter
Na /Pi-cotransporter	Na/Pi-cotransporter
NapD	
NifR3 family protein	NifR3 family protein
NifU family protein	NifU family protein
O-Antigen Polymerase family	O-Antigen Polymerase family
O-acetylhomoserine sulfhydrylase	O-acetylhomoserine sulfhydrylase
O-sialoglycoprotein endopeptidase (Glycoprotease)	O-sialoglycoprotein endopeptidase (Glycoprotease)
Omp18	Omp18 protein
OorA subunit of 2-oxoglutarate:acceptor oxidoreductase	2-oxoglutarate:acceptor oxidoreductase, OorA subunit
OorB subunit of 2-oxoglutarate:acceptor oxidoreductase	
OorC subunit of 2-oxoglutarate:acceptor oxidoreductase	
OorD subunit of 2-oxoglutarate:acceptor oxidoreductase	
OstA family protein	OstA family protein
P-type DNA transfer ATPase VirB11	P-type DNA transfer ATPase VirB11
P-type conjugative transfer protein VirB9	P-type conjugative transfer protein VirB9
PAS/PAC sensor signal transduction histidine kinase	PAS/PAC sensor signal transduction histidine kinase
PP-loop family protein	PP-loop family protein
Plp4	Plp4 protein
RDD protein	RDD protein
RIP metalloprotease RseP	RIP metalloprotease RseP
RNA methyltransferase, TrmH family	RNA methyltransferase, TrmH family
RNA methyltransferase, TrmH family, group 3	RNA methyltransferase, TrmH family
RNA polymerase sigma factor RpoD (Sigma-A) (Major vegetative sigmafactor)	RNA polymerase sigma factor RpoD
RND efflux system, outer membrane lipoprotein CmeC	RND efflux system, outer membrane lipoprotein CmeC
RNase H	RNase H
RTX toxins and related Ca2 -binding protein	RTX toxins and related Ca2-binding protein
RarD protein	RarD protein
RfpB	RfpB protein
S-Ribosylhomocysteinase (LuxS)	S-Ribosylhomocysteinase (LuxS)
S-adenosyl-methyltransferase MraW	S-adenosyl-methyltransferase MraW
S4 domain protein	S4 domain protein
SMF family protein	SMF family protein
Ser/Thr protein phosphatase family protein	Ser/Thr protein phosphatase family protein
TM2	TM2 protein
TPR domain protein	TPR domain protein
TPR repeat	TPR repeat-containing protein
ThiF family protein	ThiF family protein
TonB-system energizer ExbB	TonB-system energizer ExbB
TrbM protein	
TrkA	TrkA protein
TrkA domain protein	TrkA domain-containning protein
UDP-3-O-[3-hydroxymyristoyl] glucosamine N-acyltransferase	UDP-3-O-[3-hydroxymyristoyl] glucosamine N-acyltransferase
UDP-N-acetylglucosamine diphosphorylase/glucosamine-1-phosphate N-acetyltransferase	UDP-N-acetylglucosamine diphosphorylase/glucosamine-1-phosphate N-acetyltransferase
UDP-N-acetylmuramate--alanine ligase	UDP-N-acetylmuramate--alanine ligase
UDP-N-acetylmuramoylalanyl-D-glutamate--2, 6-diaminopimelate ligase	UDP-N-acetylmuramoylalanyl-D-glutamate--2, 6-diaminopimelate ligase
UvrD/REP helicase	UvrD/REP helicase
Xaa-Pro peptidase	Xaa-Pro peptidase
YbaK/ebsC protein	YbaK/ebsC protein
YfgH	
YjeF-related protein	YjeF-related protein
Zn-dependent protease with chaperone function	Zn-dependent protease with chaperone function
[NiFe] hydrogenase maturation protein HypF	[NiFe] hydrogenase maturation protein HypF
acetolactate synthase, large subunit, biosynthetic type	biosynthetic-type acetolactate synthase large subunit
acetyl-CoA carboxylase, biotin carboxylase	acetyl-CoA carboxylase, biotin carboxylase
acetyl-CoA carboxylase, carboxyl transferase, alpha subunit	acetyl-CoA carboxylase, carboxyl transferase, alpha subunit
acetyl-CoA carboxylase, carboxyl transferase, beta subunit	acetyl-CoA carboxylase, carboxyl transferase, beta subunit
acetylornithine aminotransferase (acoat)	acetylornithine aminotransferase
acetyltransferase, gnat family	acetyltransferase, GNAT family
acid membrane antigen A	acid membrane antigen A
aconitate hydratase 2	aconitate hydratase 2
adenylate kinase (ATP-AMP transphosphorylase)	adenylate kinase
alanyl-tRNA synthetase	alanyl-tRNA synthetase
alpha-2-macroglobulin family N- region	alpha-2-macroglobulin
alpha/beta hydrolase fold	alpha/beta hydrolase fold
amino acid	hypothetical protein
amino acid ABC tansporter, permease protein, His/Glu/Gln/Arg/opine family	amino acid ABC tansporter permease protein, His/Glu/Gln/Arg/opine family
aminoacyl-histidine dipeptidase	aminoacyl-histidine dipeptidase
aminotransferase, class I/II	aminotransferase class I/II
anaeroBic dimethyl sulfoxide reductase chain b (dmso reductase iron-sulfur subunit)	anaerobic dimethyl sulfoxide reductase chain b
anaerobic C4-dicarboxylate membrane transporter	anaerobic C4-dicarboxylate membrane transporter
antibiotic biosynthesis monooxygenase	antibiotic biosynthesis monooxygenase
antigenic protein	antigenic protein
arginine-binding periplasmic protein 1	arginine-binding periplasmic protein 1
arginyl-tRNA synthetase	arginyl-tRNA synthetase
arsenical-resistance protein	arsenical-resistance protein
asparate kinase, monofunctional class	asparate kinase, monofunctional class
aspartate aminotransferase (transaminase a) (aspat)	aspartate aminotransferase
aspartate ammonia-lyase (Aspartase)	aspartate ammonia-lyase
aspartyl-tRNA synthetase	aspartyl-tRNA synthetase
aspartyl/glutamyl-tRNA(Asn/Gln) amidotransferase subunit B (Asp/Glu-ADT subunit B)	aspartyl/glutamyl-tRNA(Asn/Gln) amidotransferase subunit B
bacterial Peptidase A24 N- domain family	bacterial Peptidase A24 N-terminal domain-containing protein
bacterial RNase P, class A	bacterial RNase P, class A
bacterial signal recognition particle RNA	bacterial signal recognition particle RNA
bacterioferritin comigratory protein	bacterioferritin comigratory protein
bacteriophage-related integrase	bacteriophage-related integrase
band 7/Mec-2 family protein	band 7/Mec-2 family protein
beta-hydroxyacyl-(acyl-carrier-protein) dehydratase FabZ	beta-hydroxyacyl-(acyl-carrier-protein) dehydratase FabZ
beta-lactamase HcpA (Cysteine-rich 28 kDaprotein)	beta-lactamase HcpA
bifunctional short chain isoprenyl diphosphate synthase	bifunctional short chain isoprenyl diphosphate synthase
biotin carboxylase (Acetyl-CoA carboxylase subunit A) (ACC)	biotin carboxylase
biotin/lipoyl attachment	
branched-chain amino acid transport system II carrier protein	branched-chain amino acid transport system II carrier protein
cadmium efflux system accessory protein	cadmium efflux system accessory protein
capsule biosynthesis protein	capsule biosynthesis protein
carbohydrate isomerase, KpsF/GutQ family	carbohydrate isomerase
carboxy--processing protease (C-terminal-processing protease)	carboxy--processing protease
carboxynorspermidine decarboxylase	carboxynorspermidine decarboxylase
cation ABC transporter, permease protein	cation ABC transporter, permease
cell cycle protein	cell cycle protein
cell division protein, FtsW/RodA/SpoVE family	cell division protein, FtsW/RodA/SpoVE family
chaperone ClpB	chaperone ClpB
chaperonin GroL	chaperonin GroL
chaperonin GroS	chaperonin GroS
chorismate mutase/prephenate dehydratase	chorismate mutase/prephenate dehydratase
citrate (Si)-synthase	citrate (Si)-synthase
cmgB8	cmgB8 protein
cmgb10	cmgb10 protein
cmgb3/4	cmgb3/4 protein
cmgd4	cmgd4 protein
co-chaperone GrpE	co-chaperone GrpE
co-chaperone protein DnaJ	co-chaperone protein DnaJ
cold-shock protein, DNA-binding	cold-shock protein
competence lipoprotein	competence lipoprotein
competence/damage-inducible domain protein	competence/damage-inducible domain-containing protein
conjugal transfer protein	
conserved domain protein	conserved domain protein
conserved hypothetical protein	
copper-translocating P-type ATPase	copper-translocating P-type ATPase
crispr-associated helicase Cas3 domain protein	crispr-associated helicase Cas3 domain-containing protein
crispr-associated protein Cas2	CRISPR-associated protein Cas2
crispr-associated protein Cas4	CRISPR-associated protein Cas4
crispr-associated protein Cas5, hmari subtype	crispr-associated protein Cas5, hmari subtype
crispr-associated protein Cas6	CRISPR-associated protein Cas6
cysteine desulfurase, NifS family	cysteine desulfurase, NifS family
cysteinyl-tRNA synthetase	cysteinyl-tRNA synthetase
cytochrome D ubiquinol oxidase, subunit I	cytochrome D ubiquinol oxidase, subunit I
cytochrome D ubiquinol oxidase, subunit II	cytochrome D ubiquinol oxidase, subunit II
cytochrome c biogenesis protein, CcmF/CycK/CcsA family	cytochrome c biogenesis protein, CcmF/CycK/CcsA family
cytochrome c family protein	cytochrome c family protein
cytochrome c nitrate reductase, small subunit	cytochrome c nitrate reductase, small subunit
cytochrome c oxidase accessory protein CcoG	cytochrome c oxidase accessory protein CcoG
cytochrome c oxidase, Cbb3-type, CcoQ subunit	cytochrome c oxidase, Cbb3-type, CcoQ subunit
cytochrome c oxidase, Cbb3-type, subunit I	cytochrome c oxidase, Cbb3-type, subunit I
cytochrome c oxidase, Cbb3-type, subunit II	
cytochrome c551 peroxidase (Cytochrome cperoxidase) (CCP)	cytochrome c551 peroxidase
cytochrome c553	cytochrome c553
cytosine-specific methyltransferase NlaX (M.NlaX)	
cytosol aminopeptidase (Leucine aminopeptidase) (LAP)(Leucyl aminopeptidase)	cytosol aminopeptidase
dead/deah box helicase domain protein	dead/deah box helicase domain-containing protein
deoxycytidine triphosphate deaminase	deoxycytidine triphosphate deaminase
deoxyuridine triphosphatase domain protein	deoxyuridine triphosphatase domain protein
di-trans,poly-cis-decaprenylcistransferase	di-trans,poly-cis-decaprenylcistransferase
dihydrodipicolinate reductase	dihydrodipicolinate reductase
dihydrodipicolinate synthase	dihydrodipicolinate synthase
dihydroorotase (DHOase)	dihydroorotase
divergent polysaccharide deacetylase family	divergent polysaccharide deacetylase family
dna translocase ftsk (dna translocase spoiiie)	DNA translocase FtsK
dynamin family protein	dynamin family protein
endonuclease 4 (Endonuclease IV) (EndodeoxyribonucleaseIV)	endonuclease 4
enoyl-[acyl-carrier-protein] reductase [NADH] (nadh-dependent enoyl-acp reductase)	enoyl-[acyl-carrier-protein] reductase [NADH]
exbd\tolr family transport protein	ExbD/TolR family transport protein
excinuclease ABC, A subunit	excinuclease ABC, A subunit
excinuclease ABC, B subunit	excinuclease ABC, B subunit
excinuclease ABC, C subunit	excinuclease ABC, C subunit
fatty acid/phospholipid synthesis protein PlsX	fatty acid/phospholipid synthesis protein PlsX
ferredoxin, 4Fe-4S	ferredoxin, 4Fe-4S
ferric uptake regulation protein (Ferric uptake regulator)	ferric uptake regulation protein
ferrous iron transport protein B	ferrous iron transport protein B
fibronectin type III domain protein	fibronectin type III domain-containing protein
fibronectin/fibrinogen-binding protein	fibronectin/fibrinogen-binding protein
fkbp-type peptidyl-prolyl cis-trans isomerase slyd (ppiase) (rotamase)	FKBP-type peptidyl-prolyl cis-trans isomerase SlyD
formate dehydrogenase, cytochrome B subunit	formate dehydrogenase, cytochrome B subunit
fumarase	fumarase
fumarate reductase respiratory complex, transmembrane subunit	fumarate reductase respiratory complex, transmembrane subunit
galactosyltransferase	galactosyltransferase
general glycosylation pathway protein	general glycosylation pathway protein
general secretion pathway protein E (Type II traffic warden ATPase)(Cholera toxin secretion protein EpsE)	general secretion pathway protein E
geranyltranstransferase (Farnesyl-diphosphate synthase)(FPP synthase)	geranyltranstransferase
glutamine synthetase, type I	glutamine synthetase, type I
glutamine-fructose-6-phosphate transaminase (isomerizing)	glutamine-fructose-6-phosphate transaminase (isomerizing)
glutamyl-tRNA synthetase	glutamyl-tRNA synthetase
glutamyl-tRNA(Gln) amidotransferase subunit A (Glu-ADTsubunit A)	glutamyl-tRNA(Gln) amidotransferase subunit A
glutamyl-tRNA(Gln) amidotransferase, C subunit	glutamyl-tRNA(Gln) amidotransferase, C subunit
glyceraldehyde-3-phosphate dehydrogenase, type I	glyceraldehyde-3-phosphate dehydrogenase, type I
glycerol-3-phosphate dehydrogenase (NAD(P) )	glycerol-3-phosphate dehydrogenase (NAD(P) )
glycosyl transferase, group 1 family protein	glycosyl transferase, group 1 family protein
glycyl-tRNA synthetase, alpha subunit	glycyl-tRNA synthetase, alpha subunit
glycyl-tRNA synthetase, beta subunit	glycyl-tRNA synthetase, beta subunit
gmp synthase [glutamine-hydrolyzing] (glutamineamidotransferase) (gmp synthetase) (gmps)	gmp synthase [glutamine-hydrolyzing]
haemagglutination activity domain protein	haemagglutination activity domain protein
heat shock protein HslVU, ATPase subunit HslU	heat shock protein HslVU
heat shock protein Hsp20	heat shock protein Hsp20
helix-turn-helix domain of resolvase protein	resolvase
hemolysin-type calcium binding protein	hemolysin-type calcium-binding protein
histidine triad nucleotide-binding protein 2 (hint-2)(hint-3)	histidine triad nucleotide-binding protein 2
histidyl-tRNA synthetase	histidyl-tRNA synthetase
holliday junction DNA helicase RuvA	holliday junction DNA helicase RuvA
holo-(acyl-carrier-protein) synthase	holo-(acyl-carrier-protein) synthase
homogentisate export protein	homogentisate export protein
homoserine dehydrogenase (HDH)	homoserine dehydrogenase
hydrogenase accessory protein HypB	hydrogenase accessory protein HypB
hydrogenase assembly chaperone HypC/HupF	
hydrogenase expression/formation protein HypD	hydrogenase expression/formation protein HypD
hydrogenase expression/formation protein HypE	hydrogenase expression/formation protein HypE
integral membrane protein MviN	integral membrane protein MviN
integral membrane protein-permease component	integral membrane protein-permease component
invasion antigen B	invasion antigen B
iron permease, FTR1 family	iron permease, FTR1 family
iron-sulfur cluster-binding domain protein	iron-sulfur cluster-binding domain-containing protein
isochorismatase family protein	isochorismatase family protein
isocitrate dehydrogenase, NADP-dependent	isocitrate dehydrogenase, NADP-dependent
isoleucyl-tRNA synthetase	isoleucyl-tRNA synthetase
large conductance mechanosensitive channel protein	large conductance mechanosensitive channel protein
leucyl-tRNA synthetase	leucyl-tRNA synthetase
lipoprotein release system transmembrane protein	lipoprotein release system transmembrane protein
lipoprotein, VacJ family	lipoprotein, VacJ family
lysyl-tRNA synthetase	lysyl-tRNA synthetase
lytic transglycosylase, catalytic	lytic transglycosylase, catalytic
magnesium transporter	magnesium transporter
major facilitator superfamily MFS_1	major facilitator superfamily
malate:quinone oxidoreductase (Malate dehydrogenase[acceptor]) (MQO)	malate:quinone oxidoreductase
mate efflux family protein	mate efflux family protein
mechanosensitive ion channel family protein	mechanosensitive ion channel family protein
metal transporting atpase Mta72	metal transporting atpase Mta72
metallo-beta-lactamase family protein	metallo-beta-lactamase family protein
metallophosphoesterase	metallophosphoesterase
methionine aminopeptidase, type I	methionine aminopeptidase, type I
methionyl-tRNA synthetase	methionyl-tRNA synthetase
methyltransferase GidB	methyltransferase GidB
methyltransferase domain family	methyltransferase domain-containing family
methyltransferase small	methyltransferase small
modification methylase CcrMI (Adenine-specificmethyltransferase CcrMI) (M.CcrMI)	modification methylase CcrMI
modification methylase EcoRI (Adenine-specificmethyltransferase EcoRI) (M.EcoRI)	modification methylase EcoRI
modification methylase StsI (Adenine-specificmethyltransferase StsI) (M.StsI)	modification methylase StsI
molybdate ABC transporter, permease protein	molybdate ABC transporter, permease protein
molybdenum cofactor biosynthesis protein A	molybdenum cofactor biosynthesis protein A
molybdenum cofactor biosynthesis protein C	molybdenum cofactor biosynthesis protein C
molybdopterin binding domain	molybdopterin binding domain-containing
molybdopterin biosynthesis enzyme	molybdopterin biosynthesis enzyme
molybdopterin biosynthesis mog protein	molybdopterin biosynthesis Mog protein
molybdopterin converting factor, subunit 2	molybdopterin converting factor, subunit 2
multidrug-efflux transporter	multidrug-efflux transporter
nitrite reductase (cytochrome; ammonia-forming)	nitrite reductase
nitroreductase	nitroreductase
nodulation efficiency protein D (NfeD)	nodulation efficiency protein D
nucleoside diphosphate kinase (NDK) (NDP kinase)(Nucleoside-2-P kinase)	nucleoside diphosphate kinase
nucleotidyltransferase domain protein	nucleotidyltransferase domain protein
nucleotidyltransferase family protein	nucleotidyltransferase family protein
outer membrane efflux protein	outer membrane efflux protein
outer membrane fibronectin-binding protein	outer membrane fibronectin-binding protein
outer membrane protein assembly complex, YaeT protein	outer membrane protein assembly complex, YaeT protein
oxidoreductase family, NAD-binding Rossmann fold protein	oxidoreductase family, NAD-binding Rossmann fold protein
oxidoreductase, 2-nitropropane dioxygenase family	oxidoreductase, 2-nitropropane dioxygenase family
oxidoreductase, FAD-dependent	oxidoreductase, FAD-dependent
penicillin-binding protein 1A (PBP-1a) (PBP1a)	penicillin-binding protein 1A
penicillin-binding protein 1A (PBP-1a) (PBP1a) (Penicillin-bindingprotein A)	penicillin-binding protein 1A
peptidase M10A and M12B, matrixin and adamalysin	peptidase family M10A and M12B
peptidase M23B	peptidase M23B
peptidase M48, Ste24p	Ste24 peptidase
peptidase U32	peptidase U32
peptidase, M16 family	peptidase, M16 family
peptidase, M23/M37 family	peptidase, M23/M37 family
peptidase, M48 family	
peptidyl-arginine deiminase family protein	peptidyl-arginine deiminase family protein
peptidyl-prolyl cis-trans isomerase B (PPIase B)(Rotamase B)	peptidyl-prolyl cis-trans isomerase B
periplasmiC nitrate reductase, diheme cytochrome c subunit	periplasmic nitrate reductase, diheme cytochrome c subunit
periplasmic nitrate reductase, large subunit	periplasmic nitrate reductase, large subunit
periplasmic protein	
periplasmic protein-probably involved in high-affinity fe2  transport	periplasmic protein
periplasmic solute binding protein family	periplasmic solute-binding protein
permease	permease
permease YjgP/YjgQ	permease YjgP/YjgQ
permeases of the drug/metabolite transporter	permeases of the drug/metabolite transporter
phage anti-repressor protein	phage anti-repressor protein
phage protein Gp37/Gp68	phage protein Gp37/Gp68
phage tape measure protein	phage tape measure protein
phenylacrylic acid decarboxylase (PAD)	phenylacrylic acid decarboxylase
phenylalanyl-tRNA synthetase, alpha subunit	phenylalanyl-tRNA synthetase, alpha subunit
phosphatase, Ppx/GppA family	phosphatase, Ppx/GppA family
phosphate ABC transporter, permease protein PstA	phosphate ABC transporter, permease protein PstA
phosphate ABC transporter, permease protein PstC	phosphate ABC transporter, permease protein PstC
phosphate ABC transporter, phosphate-binding protein PstS	phosphate ABC transporter, phosphate-binding protein PstS
phosphate acetyltransferase (Phosphotransacetylase)	phosphate acetyltransferase
phosphate transporter	phosphate transporter
phosphate-transport permease PitB	phosphate-transport permease PitB
phosphodiesterase, family	phosphodiesterase, family
phospholipase, patatin family	phospholipase, patatin family
phosphomannomutase/phosphoglucomutase (PMM/PGM)	phosphomannomutase/phosphoglucomutase
phosphopantothenoylcysteine decarboxylase/phosphopantothenate--cysteine ligase	phosphopantothenoylcysteine decarboxylase/phosphopantothenate--cysteine ligase
phosphoribosyl-AMP pyrophosphatase/phosphoribosyl-ATP cyclohydrolase	phosphoribosyl-AMP pyrophosphatase/phosphoribosyl-ATP cyclohydrolase
phosphoribosylaminoimidazole carboxylase, catalytic subunit	phosphoribosylaminoimidazole carboxylase, catalytic subunit
phosphoribosylformimino-5-aminoimidazole carboxamide ribotide isomerase	phosphoribosylformimino-5-aminoimidazole carboxamide ribotide isomerase
phosphoribosylformylglycinamidine synthase I	phosphoribosylformylglycinamidine synthase I
phosphoribosylformylglycinamidine synthase II	phosphoribosylformylglycinamidine synthase II
phosphoribosylformylglycinamidine synthase, PurS protein	phosphoribosylformylglycinamidine synthase PurS
phosphoserine phosphatase SerB	phosphoserine phosphatase SerB
polar amino acid ABC uptake transporter substrate binding protein	polar amino acid ABC uptake transporter substrate binding protein
polyA polymerase family protein	polyA polymerase family protein
polyribonucleotide nucleotidyltransferase (Polynucleotidephosphorylase) (PNPase)	polyribonucleotide nucleotidyltransferase
polysaccharide biosynthesis protein	polysaccharide biosynthesis protein
polysaccharide deacetylase family protein	polysaccharide deacetylase family protein
preprotein translocase, SecA subunit	preprotein translocase, SecA subunit
preprotein translocase, SecE subunit	preprotein translocase, SecE subunit
preprotein translocase, SecG subunit	preprotein translocase, SecG subunit
preprotein translocase, SecY subunit	preprotein translocase, SecY subunit
preprotein translocase, YajC subunit	
probable UDP-N-acetyl-D-mannosaminuronic acid transferase (UDP-ManNAcA transferase)	probable UDP-N-acetyl-D-mannosaminuronic acid transferase
probable inorganic polyphosphate/ATP-NAD kinase (Poly(P)/ATP NAD kinase)	probable inorganic polyphosphate/ATP-NAD kinase
processing protease	protease
prokaryotic N- methylation motif domain protein	prokaryotic N-terminal methylation motif domain-containing protein
prolyl-tRNA synthetase	prolyl-tRNA synthetase
prophage protein	prophage protein
protease do	protease Do
protein CysQ	protein CysQ
protein ThiJ	protein ThiJ
protein TolB	protein TolB
protein YegH	
protein YhbP	
protein containing DUF88	protein containing DUF88
protein in sno 5'region (ORF7)	
protein of unknown function	
proton/sodium-glutamate symport protein (Glutamate-aspartate carrierprotein)	
pseudouridine synthase	pseudouridine synthase
pseudouridine synthase, RluA family	
putative 4-hydroxybenzoate polyprenyltransferase	putative 4-hydroxybenzoate polyprenyltransferase
putative 6-pyruvoyl tetrahydrobiopterin synthase (ptps)(ptp synthase)	putative 6-pyruvoyl tetrahydrobiopterin synthase
putative ABC transport system periplasmic substrate-binding protein	putative ABC transport system periplasmic substrate-binding protein
putative ABC transporter, permease protein	putative ABC transporter, permease protein
putative AcbV	putative AcbV protein
putative Cell division protease FtsH-like protein	
putative D-glucuronyl C5-epimerase (Heparin/heparansulfate:glucuronic acid C5 epimerase)	putative D-glucuronyl C5-epimerase
putative DNA-directed RNA polymerase II, large subunit	putative DNA-directed RNA polymerase II, large subunit
putative LMP1	putative LMP1 protein
putative Mg chelatase-like protein	putative Mg chelatase-like protein
putative Na /solute symporter	putative Na /solute symporter
putative TPR Domain containing protein	putative TPR domain-containing protein
putative TonB family C- domain protein	putative TonB family C-terminal domain-containing protein
putative WfaX	putative WfaX protein
putative adenylate kinase (ATP-AMP transphosphorylase)	putative adenylate kinase
putative ankyrin repeat protein	putative ankyrin repeat protein
putative bacteriophage DNA transposition protein A	putative bacteriophage DNA transposition protein A
putative beta-lactamase HcpC (Cysteine-richprotein C)	putative beta-lactamase HcpC
putative chemotaxis protein MotB	putative chemotaxis protein MotB
putative chorismate binding enzyme	putative chorismate binding enzyme
putative chromosome condensation protein	putative chromosome condensation protein
putative cobalt ABC transporter CbiQ, permease subunit	putative cobalt ABC transporter CbiQ, permease subunit
putative conserved hypothetical protein	putative conserved hypothetical protein
putative cysteine repeat modular protein 1 PbCRM1	putative cysteine repeat modular protein 1
putative cytochrome c family protein	putative cytochrome c family protein
putative deoxyribonuclease Sll1786	putative deoxyribonuclease Sll1786
putative diguanylate cyclase/phosphodiesterase	putative diguanylate cyclase/phosphodiesterase
putative domain of unknown function	hypothetical protein
putative endonuclease/exonuclease/phosphatase	putative endonuclease/exonuclease/phosphatase
putative filamentous haemagglutinin family protein, intein-containing protein	putative filamentous haemagglutinin family protein, intein-containing protein
putative fusobacterium outer membrane protein family	putative fusobacterium outer membrane protein family
putative helix-turn-helix containsing protein	putative helix-turn-helix domain-containing protein
putative hemolysin activation protein HecB	putative hemolysin activation protein HecB
putative high-molecular-weight surface-exposed protein	putative high-molecular-weight surface-exposed protein
putative integrase, phage family	putative integrase, phage family
putative large adhesin	putative large adhesin
putative membrane-associated, metal-dependent hydrolase	putative membrane-associated, metal-dependent hydrolase
putative membrane-fusion protein	putative membrane-fusion protein
putative mercuric ion binding protein	putative mercuric ion binding protein
putative methyl transferase	putative methyl transferase
putative molybdopterin-guanine dinucleotide biosynthesis protein	putative molybdopterin-guanine dinucleotide biosynthesis protein
putative nicotinate (nicotinamide) nucleotide adenylyltransferase	putative nicotinate/nicotinamide nucleotide adenylyltransferase
putative nitroimidazole resistance protein	putative nitroimidazole resistance protein
putative peptidyl-prolyl cis-trans isomerase D-like protein	putative peptidyl-prolyl cis-trans isomerase D-like protein
putative periplasmic protein	
putative permease, YjgP/YjgQ family	putative permease, YjgP/YjgQ family
putative perosamine synthetase	putative perosamine synthetase
putative phage virion morphogenesis protein	putative phage virion morphogenesis protein
putative phosphoglycerol transferase I (Phosphatidylglycerol--membrane-oligosaccharide glycerophosphotransferase)	putative phosphoglycerol transferase I
putative prepilin-type N- cleavage/methylation domain protein	prepilin-type N-terminal cleavage/methylation domain-containing protein
putative probable lipopolysaccharide biosynthesis protein	putative probable lipopolysaccharide biosynthesis protein
putative prophage MuSo1, F protein	putative prophage MuSo1, F protein
putative prophage integrase	putative prophage integrase
putative quinolone resistence protein, major facilitator family transporter	putative quinolone resistence protein, major facilitator family transporter
putative secreted protein	putative secreted protein
putative secreted protein, autotransporter domain	
putative secy-independent transporter protein	putative secy-independent transporter protein
putative site-specific recombinase, phage integrase family	putative site-specific recombinase, phage integrase family
putative sulfatase	putative sulfatase
putative sulfatase family protein	putative sulfatase family protein
putative tmRNA	transfer-messenger RNA
putative uracil-DNA glycosylase superfamily	putative uracil-DNA glycosylase superfamily
putative zinc protease	putative zinc protease
pyridoxal phosphate biosynthetic protein PdxJ	pyridoxal phosphate biosynthetic protein PdxJ
pyruvate:ferredoxin (flavodoxin) oxidoreductase	pyruvate:ferredoxin (flavodoxin) oxidoreductase
quinol dehydrogenase membrane component	quinol dehydrogenase membrane component
rAre lipoprotein A rlpa	rare lipoprotein A RlpA
radical SAM domain protein	radical SAM domain protein
radical SAM enzyme, Cfr family	radical SAM enzyme, Cfr family
recombination and DNA strand exchange inhibitor protein	recombination and DNA strand exchange inhibitor protein
redoxin superfamily	thioredoxin superfamily protein
regulatory protein dnir	regulatory protein DniR
relaxase/Mobilization nuclease domain protein	relaxase/mobilization nuclease domain-containing protein
response regulator receiver domain protein	response regulator receiver domain-containing protein
restriction endonuclease R.IB	restriction endonuclease
rhomboid family protein	rhomboid family protein
riboflavin biosynthesis protein RibF	riboflavin biosynthesis protein RibF
riboflavin biosynthesis protein ribAB	riboflavin biosynthesis protein ribAB
riboflavin synthase, alpha subunit	riboflavin synthase, alpha subunit
ribonuclease P protein component (RNaseP protein) (RNaseP protein) (Protein C5)	ribonuclease P protein component
ribonucleoside-diphosphate reductase, alpha subunit	ribonucleoside-diphosphate reductase, alpha subunit
ribosomal protein L1	ribosomal protein L1
ribosomal protein L11	ribosomal protein L11
ribosomal protein L13	ribosomal protein L13
ribosomal protein L14	ribosomal protein L14
ribosomal protein L15	ribosomal protein L15
ribosomal protein L16	ribosomal protein L16
ribosomal protein L17	ribosomal protein L17
ribosomal protein L19	ribosomal protein L19
ribosomal protein L2	
ribosomal protein L20	ribosomal protein L20
ribosomal protein L21	ribosomal protein L21
ribosomal protein L22	ribosomal protein L22
ribosomal protein L23	ribosomal protein L23
ribosomal protein L24	ribosomal protein L24
ribosomal protein L25, Ctc-form	ribosomal protein L25, Ctc-form
ribosomal protein L27	ribosomal protein L27
ribosomal protein L28	ribosomal protein L28
ribosomal protein L29	ribosomal protein L29
ribosomal protein L31	ribosomal protein L31
ribosomal protein L32	ribosomal protein L32
ribosomal protein L33	ribosomal protein L33
ribosomal protein L34	ribosomal protein L34
ribosomal protein L35	ribosomal protein L35
ribosomal protein L4/L1 family	ribosomal protein L4/L1 family
ribosomal protein L7/L12	ribosomal protein L7/L12
ribosomal protein L9	ribosomal protein L9
ribosomal protein S10	ribosomal protein S10
ribosomal protein S11	ribosomal protein S11
ribosomal protein S12	ribosomal protein S12
ribosomal protein S13p/S18e	ribosomal protein S13p/S18e
ribosomal protein S14p/S29e	ribosomal protein S14p/S29e
ribosomal protein S15	ribosomal protein S15
ribosomal protein S16	ribosomal protein S16
ribosomal protein S17	ribosomal protein S17
ribosomal protein S18	ribosomal protein S18
ribosomal protein S19	ribosomal protein S19
ribosomal protein S2	ribosomal protein S2
ribosomal protein S20	ribosomal protein S20
ribosomal protein S21	ribosomal protein S21
ribosomal protein S3	ribosomal protein S3
ribosomal protein S4	ribosomal protein S4
ribosomal protein S5	ribosomal protein S5
ribosomal protein S6	ribosomal protein S6
ribosomal protein S7	ribosomal protein S7
ribosomal protein S8	ribosomal protein S8
ribosomal protein S9	ribosomal protein S9
secreted protein	secreted protein
selenocysteine-specific translation elongation factor	selenocysteine-specific translation elongation factor
sensor histidine kinase	sensor histidine kinase
sensor histidine kinase/response regulator	sensor histidine kinase/response regulator
sensory trasnduction histidine kinase	sensory trasnduction histidine kinase
seryl-tRNA synthetase	seryl-tRNA synthetase
seryl-tRNA synthetase (Serine--tRNA ligase) (SerRS)	seryl-tRNA synthetase
sigma 54 modulation protein/ribosomal protein S30EA	sigma 54 modulation protein/ribosomal protein S30EA
signal peptide peptidase SppA, 36K type	signal peptide peptidase SppA, 36K type
signal-transduction sensor protein-pas/pac domain	signal-transduction sensor protein-pas/pac domain
single-strand binding protein family	single-strand binding protein family
single-stranded DNA-binding protein (SSB) (Helix-destabilizingprotein)	single-stranded DNA-binding protein
site-specific recombinase, phage integrase family	site-specific recombinase, phage integrase family
small GTP-binding protein domain	small GTP-binding protein domain
sodium- and chloride-dependent transporter	sodium- and chloride-dependent transporter
sodium-dependent transporter	sodium-dependent transporter
sodium-dependent tyrosine transporter	sodium-dependent tyrosine transporter
sodium/hydrogen exchanger family protein	sodium/hydrogen exchanger family protein
spfh domain	SPFH domain-containing protein
spoOJ protein	spoOJ protein
ss-1,4-galactosyltransferase	ss-1,4-galactosyltransferase
succinate-CoA ligase, alpha subunit subfamily	succinate-CoA ligase, alpha subunit subfamily
succinate-semialdehyde dehydrogenase [NADP ] (ssdh)	succinate-semialdehyde dehydrogenase [NADP+]
succinyl-CoA synthetase beta chain (SCS-alpha)(Vegetative protein 63) (VEG63)	succinyl-CoA synthetase beta chain
sulfatase domain protein	sulfatase domain protein
sulfate/thiosulfate import ATP-binding protein CysA (Sulfate-transporting ATPase)	sulfate/thiosulfate import ATP-binding protein CysA
superoxide dismutase (Fe)	superoxide dismutase [Fe]
tRNA (5-methylaminomethyl-2-thiouridylate)-methyltransferase	tRNA (5-methylaminomethyl-2-thiouridylate)-methyltransferase
tRNA (guanine-N(7)-)-methyltransferase (tRNA(m7G46)-methyltransferase)	tRNA (guanine-N(7)-)-methyltransferase
tRNA (guanine-N1)-methyltransferase	tRNA (guanine-N1)-methyltransferase
tRNA (uracil-5-)-methyltransferase	tRNA (uracil-5-)-methyltransferase
tRNA delta(2)-isopentenylpyrophosphate transferase	tRNA delta(2)-isopentenylpyrophosphate transferase
tRNA modification GTPase TrmE	tRNA modification GTPase TrmE
tRNA synthetase, class II	tRNA synthetase, class II
tRNA uridine 5-carboxymethylaminomethyl modification enzyme GidA (Glucose-inhibited division protein A)	tRNA uridine 5-carboxymethylaminomethyl modification enzyme GidA
tRNA-Ala	tRNA-Ala
tRNA-Arg	tRNA-Arg
tRNA-Asn	tRNA-Asn
tRNA-Asp	tRNA-Asp
tRNA-Cys	tRNA-Cys
tRNA-Gln	tRNA-Gln
tRNA-Glu	tRNA-Glu
tRNA-Gly	tRNA-Gly
tRNA-His	tRNA-His
tRNA-I(6)A37 thiotransferase enzyme MiaB	tRNA-I(6)A37 thiotransferase enzyme MiaB
tRNA-Ile	tRNA-Ile
tRNA-Leu	tRNA-Leu
tRNA-Lys	tRNA-Lys
tRNA-Met	tRNA-Met
tRNA-Phe	tRNA-Phe
tRNA-Pro	tRNA-Pro
tRNA-Sec	tRNA-Sec
tRNA-Ser	tRNA-Ser
tRNA-Thr	tRNA-Thr
tRNA-Trp	tRNA-Trp
tRNA-Tyr	tRNA-Tyr
tRNA-Val	tRNA-Val
tetraacyldisaccharide-1-P 4'-kinase	
tetratricopeptide repeat domain protein	tetratricopeptide repeat domain-containing protein
thiamine biosynthesis protein ThiC	thiamine biosynthesis protein ThiC
thiamine biosynthesis protein ThiS	thiamine biosynthesis protein ThiS
thiamine biosynthesis protein:ExsB	thiamine biosynthesis protein
thiamine-monophosphate kinase (Thiamine-phosphatekinase)	thiamine-monophosphate kinase
thiazole biosynthesis protein ThiG	
thiazole biosynthesis protein ThiH	
thioesterase family protein	thioesterase family protein
thiol peroxidase (Scavengase P20)	thiol peroxidase
thiol:disulfide interchange protein DsbD (Protein-disulfide reductase) (Disulfide reductase)	thiol:disulfide interchange protein DsbD
thioredoxin domain protein	thioredoxin domain-containing protein
thiredoxin	thioredoxin
threonine dehydratase catabolic (Threonine deaminase)	catabolic threonine dehydratase
threonyl-tRNA synthetase	threonyl-tRNA synthetase
thymidylate synthase, flavin-dependent	thymidylate synthase, flavin-dependent
transcription Regulator Protein	transcription Regulator Protein
transcription regulator	transcription regulator
transcription termination factor NusA	transcription termination factor NusA
transcription termination/antitermination factor NusG	transcription termination/antitermination factor NusG
transcriptional regulator, AraC family	transcriptional regulator, AraC family
transcriptional regulator, BadM/Rrf2 family	
transcriptional regulator, Fis family	transcriptional regulator, Fis family
transcriptional regulator, Fur family	
transcriptional regulator, ModE family	
transferase, hexapeptide repeat family	transferase, hexapeptide repeat family
transformation system protein	transformation system protein
translation elongation factor G	translation elongation factor G
translation elongation factor Ts	translation elongation factor Ts
translation elongation factor Tu	translation elongation factor Tu
transmembrane signal peptide protein	transmembrane signal peptide protein
transmembrane transport protein	transmembrane transport protein
transport associated protein 4	transport associated protein 4
transporter, LysE family	transporter, LysE family
transporter, NadC family	transporter, NadC family
transporter, Ni2 -Co2  transporter	nickel/cobalt Transporter
transporter, auxin efflux carrier (AEC) family	transporter, auxin efflux carrier family
trap dicarboxylate transporter, dctm subunit	trap dicarboxylate transporter, dctm subunit
trap-type mannitol/chloroaromatic compound transport system, periplasmic component	trap-type mannitol/chloroaromatic compound transport system, periplasmic component
trimethylamiNe-n-oxide reductase 2 (tmaoreductase 2) (trimethylamine oxidase 2)	trimethylamiNe-n-oxide reductase 2
tripartite ATP-independent periplasmic transporter, DctQ component	tripartite ATP-independent periplasmic transporter, DctQ component
tryptophan synthase, alpha subunit	tryptophan synthase, alpha subunit
tryptophan synthase, beta subunit	tryptophan synthase, beta subunit
tryptophanyl-tRNA synthetase	tryptophanyl-tRNA synthetase
twin arginine-targeting protein translocase TatC	twin arginine-targeting protein translocase TatC
twin argininte translocase protein A	twin argininte translocase protein A
twin-arginine translocation protein TatA/E	twin-arginine translocation protein TatA/E
twitching motility protein PilT	twitching motility protein PilT
two component transcriptional regulator, winged helix family	two component transcriptional regulator, winged helix family
two-component regulator	two-component regulator
two-component sensor	two-component sensor
type I secretion target ggxgxdxxx repeat (2 copies) domain protein	type I secretion target ggxgxdxxx repeat domain-containing protein
type I secretion target ggxgxdxxx repeat domain protein	type I secretion target ggxgxdxxx repeat domain-containing protein
type II and III secretion system protein	type II and III secretion system protein
type II secretion system protein	type II secretion system protein
type III pantothenate kinase (Pantothenic acid kinase)(PanK-III)	type III pantothenate kinase
type III restriction-modification system: methylase	type III restriction-modification system: methylase
tyrosyl-tRNA synthetase	tyrosyl-tRNA synthetase
ubiquinol--CytoChrome c reductase, cytochrome c1 subunit	ubiquinol--CytoChrome c reductase, cytochrome c1 subunit
ubiquinone/menaquinone biosynthesis methyltransferase UbiE	ubiquinone/menaquinone biosynthesis methyltransferase UbiE
universal stress protein family	universal stress protein family
uridine diphosphate glucose pyrophosphatase	
valyl-tRNA synthetase	valyl-tRNA synthetase
virulence factor mvin superfamily	virulence factor mvin superfamily
yggt family protein	yggt family protein
zeta toxin superfamily	zeta toxin superfamily
